Scene: title, Layer: BG1, VRAM offset: 0x0000
Format: [row,col] tile=NNN pal=N pri=N hflip=N vflip=N raw=0xXXXX

  0   0   0   0   0   0   0   0   0   0   0   0   0   0   0   0   0 255   0   0   0   0   0   0   0 255 130 112   0  66  64  64
 64  64 771 135 656 837 135   0   0   1 519 128 256  10   0   0   0   0   0   0   0   0   0   2 512 980   0   0  16   0  16   0
 16 256 783 257   1 256 108 112 518   0 232   0   0   0 216   0   0 258 224 736 126   0   0   0   0   0   0   0   0   0   0 768
255   0   0   0   0   0   0   0   0 148   0   0   0   0   0   0   0   0   0   0   0   0   0   0   0   0   0   0   0   0   0   0
305 652 117 313 398 784 404 706 732 973 764 380 170 810 676 985 583 1005 872 276 763 665 393 502 892 612 121 320 802 335 198 113
794 126 655 891 916 418 218 211 527 692 407 165 850 207 344 110 810 627 793 386  22 602 209 956 156 623 742 630 181 507 734 581
408 389   2 491 420 245 349 324 566 726 875 519 569 996 562 822 211 566 815 519 359 920  73 565 748 920 834  71 394 774   0   0
640  54   0 164  14 632 132 144   0 164  14 128 144 144 128   0 640 128 130 256 145 987 585 620 139 577 668   0 633 619 644 128
 14 289 242 288 226 288 210 288 194 288  54 288  38 288  22 288 130  70 130  68 130  67 138  66 178  83 186  82 146 166 162 164
178 162 146 134 162 132 178 130 146 102 162 100 178  98 194 128 194  96 194  64  74 219  66 218 122 203 114 202 114 204 114 206
 98 238  50 264  50 232  50 200  98 302  82 300  66 298  98 270  82 268  66 266  82 236  66 234  96 332   0   0   0   0   0   0
  0   0   0   0   0   0   0   0   0   0   0   0   0   0   0   0   0   0   0   0   0   0   0   0   0   0   0   0   0   0   0   0
  0   0   0   0   0   0   0   0   0   0   0   0   0   0   0   0   0   0   0   0   0   0   0   0   0   0   0   0   0   0   0   0
  0   0   0   0   0   0   0   0   0   0   0   0   0   0   0   0   0   0   0   0   0   0   0   0   0   0   0   0   0   0   0   0
  0   0   0   0   0   0   0   0   0   0   0   0   0   0   0   0   0   0   0   0   0   0   0   0   0   0   0   0   0   0   0   0
  0   0   0   0   0   0   0   0   0   0   0   0   0   0   0   0   0   0   0   0   0   0   0   0   0   0   0   0   0   0   0   0
672  10 682  10 682 170   0   0   0   0   0   0   0   0   0   0   0   0   0   0   0   0   0   0   0   0   0   0   0   0   0   0
  0   0   0 286   0   0   4   0   0   0   0   0   0   0   0   0   0   0   0   0   0   0   0   0   0   0   0   0   0   0   0   0
  0   0   0   0   0   0   0   0   0   0   0   0   0   0   0   0   0   0   0   0   0   0   0   0   0   0   0   0   0   0   0   0
  0   0   0   0   0   0   0   0   0   0   0   0   0   0   0   0   0   0   0   0   0   0   0   0   0   0   0   0   0   0   0   0
  0   0   0   0   0   0   0   0   0   0   0   0   0   0   0   0   0   0   0   0   0   0   0   0   0   0   0   0   0   0   0   0
  0   0   0   0   0   0   0   0   0   0   0   0   0   0   0   0   0   0   0   0   0   0   0   0   0   0   0   0   0   0   0   0
  0   0   0   0   0   0   0   0   0   0   0   0   0   0   0   0   0   0   0   0   0   0   0   0   0   0   0   0   0   0   0   0
  0   0   0   0   0   0   0   0   0   0   0   0   0   0   0   0   0   0   0   0   0   0   0   0   0   0  50  39 551 126   0   0
768   0   0   0   0   0   0   0 768   0   0   0   0   0   0   0   0   0   0   0   0   0   0   0   0   0   0   0   0   0   0   0
  0   0   0   0   0   0   0   0   0   0   0   0   0   0   0   0   0   0   0   0   0   0   0   0   0   0   0   0   0   0   0   0
  0   0   0   0   0   0   0   0   0 544 256  49   0  21   0   0 545   0   0   0   0 1023 1023 255   0   0   0   0   0   0   0   0
  0 216 277 624 113 224   0   0   0   0   0   0   0   0   0   0   0   0   0   0   0   0   0   0  21   7   7   0   0   0 256 442
  0   0   0   0   0   0   0   0   0   0   0   0   0   0   0   0   0   0   0   0   0   0   0   0   0   0   0   0   0   0   0   0
  0   0   0   0   0   0   0   0   0   0   0   0   0   0   0   0   0   0   0   0   0   0   0   0   0   0   0   0   0   0   0   0
  0   0   0   0   0   0   0   0   0   0   0   0   0   0   0   0   0   0   0   0   0   0   0   0   0   0   0   0   0   0   0   0
128   0   0   0   0   0   0   0   0   0   0   0   0   0   0   0   0   0   0   0   0   0   0   0   0   0   0   0   0   0   0   0
