Scene: town, Layer: BG1, VRAM offset: 0x0000
Format: [row,col] tile=NNN pal=N pri=N hflip=N vflip=N raw=0xXXXX

255   0   0 546 894 512   0   0 514 896 832 126 571   0   0   0 640 152   0   0   0   0   0   0 256 255 232 108  72 160 985 406
407   0   3 387 686 729 382 673   0 256 519   0 768  23   0   0   0   0   0   0   0   0   0   2   0 896  61 152   0   0   0   0
  0 256 783 771   4 256 305  89   0  32 176  32 176   0   0  32 176 902 224 224 180   0 639 234 964 1023   0 988   0   0   0 768
255  84   0   0   0   0   0 176 385 181   0   0   0   0   0   0 511   0 158 641 292 158 904 116 159   0 576 126 847 804 222   0
305 652 117 313 398 784 404 706 732 973 764 380 170 810 676 985 583 1005 872 276 763 665 393 502 892 612 121 320 802 335 198 113
794 126 655 891 916 418 218 211 527 692 407 165 850 207 344 110 810 627 793 386  22 602 209 956 156 623 742 630 181 507 734 581
144   0 128 256   0  84 861 388 384 128  64 541 490   0 126 661 255 128   0 640 128 130 364 128  47  66   0 128   0 384 184 595
153  83   0   0 501 985 493 430 693 512 748 747   0 144  93 101 473 638 512 689 154 672   0 184 151 586 649 640 129 607 644 128
112 352 120 354 112 356 128 372 168  82 160  72 175  81 167  80 128 170 120 169 112 168 120 169 112 168 120 169 112 168  52  33
144  25 136  24 136  24 178 138 146 110 162 108 178 106 194 136 194  72  74  83  66  82 122  67 114  66 114  68 114  70  98 166
 82 164  66 162  98 134  82 132  66 130  98 102  82 100  66  98  50 128  50  96  50  64  66 234  96 332   0   0   0   0   0   0
  0   0   0   0   0   0   0   0   0   0   0   0   0   0   0   0   0   0   0   0   0   0   0   0   0   0   0   0   0   0   0   0
  0   0   0   0   0   0   0   0   0   0   0   0   0   0   0   0   0   0   0   0   0   0   0   0   0   0   0   0   0   0   0   0
  0   0   0   0   0   0   0   0   0   0   0   0   0   0   0   0   0   0   0   0   0   0   0   0   0   0   0   0   0   0   0   0
  0   0   0   0   0   0   0   0   0   0   0   0   0   0   0   0   0   0   0   0   0   0   0   0   0   0   0   0   0   0   0   0
  0   0   0   0   0   0   0   0   0   0   0   0   0   0   0   0   0   0   0   0   0   0   0   0   0   0   0   0   0   0   0   0
 10   0   0   0   0   0   0   0   0   0   0   0   0   0   0   0   1   0 512 606  94   0   0   0   0   0   0   0   0   0   0   0
  0   0   0  50   1   0   4   0   0   0   0   0   0   0   0   0   0   0   0   0   0   0   0   0   0   0   0   0   0   0   0   0
  0   0   0   0   0   0   0   0   0   0   0   0   0   0   0   0   0   0   0   0   0   0   0   0   0   0   0   0   0   0   0   0
  0   0   0   0   0   0   0   0   0   0   0   0   0   0   0   0   0   0   0   0   0   0   0   0   0   0   0   0   0   0   0   0
  0   0   0   0   0   0   0   0   0   0   0   0   0   0   0   0   0   0   0   0   0   0   0   0   0   0   0   0   0   0   0   0
  0   0   0   0   0   0   0   0   0   0   0   0   0   0   0   0   0   0   0   0   0   0   0   0   0   0   0   0   0   0   0   0
  0   0   0   0   0   0   0   0   0   0   0   0   0   0   0   0   0   0   0   0   0   0   0   0   0   0   0   0   0   0   0   0
  0   0   0   0   0   0   0   0   0   0   0   0   0   0   0   0   0   0   0   0   0   0   0   0   0   0  50  39 551 126  32   0
  0 771   0   0   0   0   0   0   0 771   0   0   0   0   0   0   0   0   0   0   0   0   0   0   0   0   0   0   0   0   0   0
  0   0   0   0   0   0   0   0   0   0   0   0   0   0   0   0   0   0   0   0 512   0   0 136   1   1   6   0   0   0   0   0
  0   0 132   0   0 770 770  10   4   1 256 264 264  21 1023 255 545   0 512 769 1023 903 1023 1023 1023 1023 255 255   0  19 1023 255
  0   0  23 601 115 224   0   0   0   0   0   0   0   0   0   0   0   0   0   0   0   0   0   0   7  12  12   0   0   0 768 922
527   0   0   0   0  11 315 864 606 804 162 164 672 533  24 168  24 168  24 168  24 936   0  96   0  96   0  96   0  96 585 672
585 672 585 672   0   0 816 816 816 816 816 816 816 816 508 972 508 972 508 972 508 972 410 448 410 448 410 448   0   0   2   8
  8   0   0   0   0   0   0   0   0   0   0   0   0   0   0   0   0   0   0   0   0   0   0 1023 1023  64 384 960   8 255   1 255
128 640   0   0  12   0   0   0   0   0 558 783 791 783 783 783 783 783   0   0   0   0   0 792   0 771   8  46  48   0   0   0
