Scene: wm_explore, Layer: BG2, VRAM offset: 0x0800
Format: [row,col] tile=NNN pal=N pri=N hflip=N vflip=N raw=0xXXXX

640 640 640 384 640 640 640 640 640 640 640 640 640 640 640 640   0   0   0   0   0   0   0   0   0   0   0   0   0   0   0   0
  0   0   0   0   0   0   0   0   0   0   0   0   0   0   0   0   0   0   0   0   0   0   0   0   0   0   0   0   0   0   0   0
940 780 940 512 684 736 764 844 1004 601 617 633 649 281 297 729   0   0   0   0   0   0   0   0   0   0   0   0   0   0   0   0
  0   0   0   0   0   0   0   0   0   0   0   0   0   0   0   0   0   0   0   0   0   0   0   0   0   0   0   0   0   0   0   0
768 512 768 128 768 786 768 512 768  64  72  80  88 752 760   0   0   0   0   0   0   0   0   0   0   0   0   0   0   0   0   0
  0   0   0   0   0   0   0   0   0   0   0   0   0   0   0   0   0   0   0   0   0   0   0   0   0   0   0   0   0   0   0   0
160 160 160 768  50  28  50 160 160  16  16  16  16  16  16 768   0   0   0   0   0   0   0   0   0   0   0   0   0   0   0   0
  0   0   0   0   0   0   0   0   0   0   0   0   0   0   0   0   0   0   0   0   0   0   0   0   0   0   0   0   0   0   0   0
  2 255   2   0   0   0   0 255   0 128   0 104   0   0   0   0   0 255   2 255   0   0   0   0   0   6   0   2   0 336   2   0
  0   0   0   0   0   0   0   0   0   0   0   0   0   0   0   0   0   0   0   0   0   0   0   0   0   0   0   0   0   0   0   0
  0   0   0   0   0   0   0   0   0   0   0   0   0   0   0   0   0   0   0   0   0   0   0   0   0   0   0   0   0   0   0   0
  0   0   0   0   0   0   0   0   0   0   0   0   0   0   0   0   0   0   0   0   0   0   0   0   0   0   0   0   0   0   0   0
  0   0   0   0   0   0   0   0   0   0   0   0   0   0   0   0   0   0   0   0   0   0   0   0   0   0   0   0   0   0   0   0
  0   0   0   0   0   0   0   0   0   0   0   0   0   0   0   0   0   0   0   0   0   0   0   0   0   0   0   0   0   0   0   0
  0   0   0   0   0   0   0   0   0   0   0   0   0   0   0   0   0   0   0   0   0   0   0   0   0   0   0   0   0   0   0   0
  0   0   0   0   0   0   0   0   0   0   0   0   0   0   0   0   0   0   0   0   0   0   0   0   0   0   0   0   0   0   0   0
  0   0 759 924 480   0 198 462   0   0 759 957   0   0 759  28   0   0 461 824   0   0 263 560 825   1 396 462   0 693 429 133
128 259 294 361 427 558 399 465 498 531 333 134 234 398 497 563 128  66 100 165 231 264 330 198 267 133 232 298 364 430  12   0
128 135 234 301 367 466 532 102 135 168 101 199 264 330 396 462 128 101 166 231 264 330 429 561 102 201 166 200 298 331 429 463
128 132 169 297 460 528 627 792   6  73 112 256 416 749 460 858 128  66 101 135 201 268 434 565 156 284 540 128 260 520 265 664
256  99 924 470 732 429 198 264 429 660 203  15 187 704 448 594 256  99 924 470 732 187  15 264 429 660 203 288 608 512 256 730
256  99 924 470 732 214 110 264 429 660 203 288 544 702 895 447 256  99 924 470 732 544 288 264 429 660 203 359 524 187  15 721
256  99 924 470 732 217 175 587 392 228 267 640 597 399 831 384 256  99 891 470 732 143 529 132 335 198 429 660 831 260 455 651
464 726 462 330 198 381 151 111  73  28 594 462 330 198  99 924 132 664 400 301 168 900 551 358 195 784 457 294 429 198  99 924
  0   0   0   0   0   0   0   0   0   0   0   0   0   0   0   0   0   0   0   0   0   0   0   0   0   0   0   0   0   0   0   0
  0   0   0   0   0   0   0   0   0   0   0   0   0   0   0   0   0   0   0   0   0   0   0   0   0   0   0   0   0   0   0   0
  0   0   0   0   0   0   0   0   0   0   0   0   0   0   0   0   0   0   0   0   0   0   0   0   0   0   0   0   0   0   0   0
  0   0   0   0   0   0   0   0   0   0   0   0   0   0   0   0   0   0   0   0   0   0   0   0   0   0   0   0   0   0   0   0
  0   0   0   0   0   0   0   0   0   0   0   0   0   0   0   0   0   0   0   0   0   0   0   0   0   0   0   0   0   0   0   0
  0   0   0   0   0   0   0   0   0   0   0   0   0   0   0   0   0   0   0   0   0   0   0   0   0   0   0   0   0   0   0   0
  0   0   0   0   0   0   0   0   0   0   0   0   0   0   0   0   0   0   0   0   0   0   0   0   0   0   0   0   0   0   0   0
  0   0   0   0   0   0   0   0   0   0   0   0   0   0   0   0   0   0   0   0   0   0   0   0   0   0   0   0   0   0   0   0
