Scene: wm_explore, Layer: BG3, VRAM offset: 0x1000
Format: [row,col] tile=NNN pal=N pri=N hflip=N vflip=N raw=0xXXXX

  0   0   0   0   0   0   0   0   0   0   0   0   0   0   0   0 256   0 512 250 638 640   0   0 129 760 473 382 658 128 126   0
  0   0   0   0   0   0   0   0   0   0   0   0   0   0   0   0   0   0   0   0   0   0   0   0   0   0   0   0   0   0   0   0
768  32   0 642 129 518 793 508   1 508 473 382 512   0 126 745 256  15   0 642 129 384   6   0 258 403 345 382 749   0 382 757
  0   0 1000   0   1   3 775 764 255 512   0   0   0   0   0   0   0   0   0   0   0   0   0   0   0   0   0   0   0   0   0   0
  0   0   0   0   0   0   0   0   0   0   0   0   0   0   0   0   0   0   0   0   0   0   0   0   0   0   0   0   0   0   0   0
255   0   0 311 135 581   0   0 705 993 729 382 723 256 126   0   0   0   0   0   0   0   0   0   0   0   0   0   0   0   0   0
  0   0   0   0   0   0   0   0   0   0   0   0   0   0   0   0   0   0   0   0   0   0   0   0   0   0   0   0   0   0   0   0
  0   0   6 527 126   0 663 764   0 256   0   0   0   0   0   0   0   0   0   0   0   0 789 252   0 256   0   0   0   0   0   0
  0   0   6 527 126   0 687 764   0 256   0   0   0   0   0   0 146   0  24   0 126   0 579 764   0 256   0   0   0   0   0   0
  1   0   0   0   0   0 242 764   0 256   0   0   0 103   0   0   1   0   0   0   0   0 242 764   0 256   0   0   0 103   0   0
  0   0   0   0   0   0 240 252   0 256   0   0   0   0   0   0   0   0   0   0 126   0 147 252   0 256   0   0   0   0   0   0
512 1000   0 512 126   3 789 252   0 256   0   0   0   0   0   0   2   0 1000   0 126 254 789 252   0 256   0   0   0   0   0   0
  0   0   3 512 126   0 789 252   0 256   0   0   0   0   0   0   0   0   0 516 126   0 789 252   0 256   0   0   0   0   0   0
  0   0   6 527 126   0 687 252   0 256   0   0   0   0   0   0   0   0   0 513 126   0 574 252   0 512   0   0   0   1   0   0
  0   0   0 517 126   0 527 252   0 256   0   0   0   0   0   0   0   0   4 516 126   0  44 252   0 256   0   0   0   0   0   0
  0   0   0   0   0   0   0   0   0   0   0   0   0   0   0   0   0   0   0   0   0   0   0   0   0   0   0   0   0   0   0   0
  0   0   0   0   0   0   0   0   0   0   0   0   0   0   0   0   0   0   0   0   0   0   0   0   0   0   0   0   0   0   0   0
  0   0   0   0   0   0   0   0   0   0   0   0   0   0   0   0   0   0   0   0   0   0   0   0   0   0   0   0   0   0   0   0
  0 1000   0 896   2   0 775 252 255 256   0   0   0   0   0   0   0   0   0   0   0   0   0   0   0   0   0   0   0   0   0   0
  0   0   0   0   0   0   0   0   0   0   0   0   0   0   0   0 256   1   0 642 897 595   0   0 385 675 473 382 694 896 382 696
1023 152   0 181 130 518   0   0 833 675 729 382 667   0 126 745 256   1   0 642 897 596   0   0 385 675  89 382 692 128 638 695
  0   0   0   0   0   0   0   0   0   0   0   0   0   0   0   0   0   0   0   0   0   0   0   0   0   0   0   0   0   0   0   0
  0   0   0   0   0   0   0   0   0   0   0   0   0   0   0   0   0   0   0   0   0   0   0   0   0   0   0   0   0   0   0   0
  0   0   0   0   0   0   0   0   0   0   0   0   0   0   0   0   0   0   0   0   0   0   0   0   0   0   0   0   0   0   0   0
  0   0   0   0   0   0   0   0   0   0   0   0   0   0   0   0   0   0   0   0   0   0   0   0   0   0   0   0   0   0   0   0
  0   0   0   0   0   0   0   0   0   0   0   0   0   0   0   0   0   0   0   0   0   0   0   0   0   0   0   0   0   0   0   0
  0   0   0   0   0   0   0   0   0   0   0   0   0   0   0   0   0   0   0   0   0   0   0   0   0   0   0   0   0   0   0   0
  0   0   0   0   0   0   0   0   0   0   0   0   0   0   0   0   0   0   0   0   0   0   0   0   0   0   0   0   0   0   0   0
  0   0   0   0   0   0   0   0   0   0   0   0   0   0   0   0   0   0   0   0   0   0   0   0   0   0   0   0   0   0   0   0
  0   0   0   0   0   0   0   0   0   0   0   0   0   0   0   0   0   0   0   0   0   0   0   0   0   0   0   0   0   0   0   0
  0   0   0   0   0   0   0   0   0   0   0   0   0   0   0   0   0   0   0   0   0   0   0   0   0   0   0   0   0   0   0   0
  0   0   0   0   0   0   0   0   0   0   0   0   0   0   0   0   0   0   0   0   0   0   0   0   0   0   0   0   0   0   0   0
